##########
#        #
# ##  ## #
#        #
##### ####
# #    # #
#        #
#  ####  #
#  P     #
##########
